21  21  21  21  21  21  21  21
21  21  21  21  21  21  21  21
21  140 142 142 142 142 142 142
142 129 105 105 105 105 105 105
105 107 21  21  21  21  21  21
21  21  21  21  21  21  21  21
21  21  21  21  21  21  21  21
21  21  21  21  21  21  21  21
